5 40
###..#...##.....##S...#....#...S....#...
G...###.###........######........#######
..##.#.....##..####.###....###.####.#..#
##...###.......###..###.##.###.##..#.##.
..##...###.##...#..##......########..##.